WWWWWWWWWWWWWWWWW
SR---V--B--T---PS
S-6S--S-9-S--S-8S
S5-S-O--Q--L-S7-S
S---M-U---4-A-H-S
S--S-F--Y--2-S-IS
S-1S3-S-N-S-KSX-S
SJ--G---E---D--ZS
WWWWWWWWWWWWWWWWW